#################
#     #         G
### # # ##### # #
#   # # #   # # #
# ##### # # ### #
# #     # #   # #
# # ##### ### # #
# # #   # #   # #
# # ### # ##### #
#       # #   # #
# ####### # # # #
# #   #   # #   #
### # # ### ### #
#   #   #     # #
# ########### # #
S             # #
#################
